NO textures/bricks.xpm
SO textures/bricks.xpm
WE textures/bricks.xpm
EA textures/bricks.xpm

C 35,19,73
F 15,6,40

111111111111111
100000000000001
100000000000001
100000000000001
100000000000001
100000000000001
100000000000001
100000000000001
100000000000001
111111111111111
