NO textures/bricks.xpm
SO textures/bricks.xpm
WE textures/bricks.xpm
EA textures/bricks.xpm

F 15,6,40
C 35,19,73

111111
101001
101001
101001
101001
101001
1000N1
111111

